2
190
0 0 0 0 0 17 0 0 0 0 0
0 55 0 0 0 0 0 0 0 0 0
0 0 0 34 0 0 0 0 0 0 0
0 0 0 0 0 0 0 0 0 0 0
87 55 11 11 0 0 0 0 0 0 0
71 11 0 0 11 0 0 0 0 0 0
71 0 0 27 0 0 0 0 121 0 0
71 11 0 0 11 0 0 0 0 0 0
73 55 0 0 0 0 0 0 0 0 0
75 0 0 0 22 0 0 0 121 0 0
77 55 0 0 0 0 0 0 0 0 0
79 0 0 121 0 11 11 0 0 0 0
81 0 0 121 0 0 0 0 0 0 0
83 0 0 121 0 0 0 0 0 0 0
72 0 0 0 0 0 0 0 0 0 0
72 0 0 0 0 0 0 12 121 0 12
72 0 0 25 0 0 0 11 121 0 11
72 0 0 0 0 0 0 0 121 0 0
74 0 0 0 0 0 0 0 0 0 0
76 0 21 26 21 0 0 0 0 0 0
78 0 0 0 0 0 0 0 0 0 0
80 0 0 0 0 11 11 25 25 0 0
82 0 0 0 0 0 0 0 0 0 0
84 0 0 0 0 0 0 21 26 21 0
71 0 0 0 0 0 0 0 0 0 0
71 12 25 25 12 0 0 0 0 0 0
71 0 0 0 0 0 0 0 0 0 0
85 0 0 0 0 0 0 0 0 0 0
0 0 0 0 0 23 23 0 0 0 0
0 0 0 0 24 0 0 24 0 0 0
6 0 0 102 0 0 0 0 102 0 0
0 0 0 0 0 0 0 0 0 0 0
0 0 0 0 0 0 0 0 0 0 0
88 0 39 0 0 0 0 0 11 11 0
72 0 0 0 0 0 0 11 0 0 11
72 0 0 0 0 0 0 0 0 0 0
72 0 40 0 0 0 0 11 0 0 11
74 0 0 0 0 0 0 0 0 0 0
76 0 0 42 0 0 0 0 0 0 0
78 0 0 0 0 0 0 0 0 0 0
80 0 40 0 0 11 11 0 0 0 0
82 0 0 0 0 0 0 0 0 0 0
84 0 0 41 0 0 0 0 0 0 0
71 0 0 0 0 0 0 0 50 0 0
71 12 39 0 12 0 0 0 0 0 0
71 11 0 0 11 0 0 50 0 0 0
71 0 0 0 0 0 0 0 0 0 0
73 0 0 0 0 0 0 0 22 0 0
75 0 40 0 0 0 0 122 0 0 0
77 0 0 0 0 0 0 0 0 0 0
79 0 0 41 0 11 11 0 0 0 0
81 0 0 0 0 0 0 0 0 0 0
83 0 39 0 0 0 0 0 0 0 0
72 0 0 0 122 0 0 0 0 0 0
72 0 0 42 0 0 0 12 0 0 12
72 0 0 0 0 0 0 0 0 0 0
86 0 39 121 0 0 0 0 0 0 0
0 0 0 0 0 0 0 0 0 0 0
22 12 0 42 0 102 0 0 0 0 12
0 0 0 0 0 0 0 0 0 0 0
21 0 40 0 0 0 21 0 0 0 0
28 0 0 0 11 0 0 0 0 0 0
27 0 0 0 0 0 11 0 0 0 0
27 0 0 42 0 11 0 0 0 0 0
29 0 0 0 0 0 0 11 0 0 121
69 0 0 0 0 0 0 121 0 0 0
69 0 11 0 0 0 0 0 0 11 0
89 0 0 0 0 121 0 0 0 0 0
89 0 0 121 0 0 0 0 0 0 0
69 0 11 0 0 0 0 0 0 11 0
69 121 0 0 0 0 0 0 0 0 0
90 0 0 0 0 52 0 0 0 0 0
90 0 0 0 0 52 0 0 0 0 0
69 0 0 12 52 0 0 0 12 0 0
19 0 0 0 52 0 0 0 0 0 0
20 0 11 0 0 53 0 0 0 11 0
20 0 11 0 0 53 0 0 0 11 0
16 0 0 0 0 0 53 0 0 0 0
21 0 0 12 0 0 53 0 0 0 0
21 0 0 0 12 0 0 0 0 0 0
9 0 0 0 0 0 0 0 0 0 0
21 32 0 0 0 0 0 0 0 0 32
32 0 0 0 0 0 0 0 0 0 0
32 0 0 0 11 0 0 11 0 0 0
32 0 0 0 0 0 0 0 0 25 0
62 0 0 0 0 0 0 0 0 0 0
63 0 0 11 0 0 0 0 11 0 0
62 0 0 26 0 0 0 0 26 0 0
32 0 0 0 11 0 0 11 0 0 0
32 0 0 0 0 0 0 0 0 0 0
32 0 25 0 0 0 0 0 0 0 0
32 0 0 0 11 0 0 11 0 0 0
80 0 0 0 0 0 0 0 0 0 0
82 0 0 11 0 0 0 0 0 0 0
75 0 0 0 0 0 0 58 0 0 0
77 0 0 37 0 0 0 0 0 0 0
79 0 0 0 0 0 0 0 0 0 0
81 0 0 38 0 0 0 0 11 0 0
76 0 0 0 66 0 0 0 0 0 0
78 0 0 0 0 0 0 0 0 0 0
62 0 0 0 67 12 12 0 0 0 0
62 0 0 0 0 12 12 0 0 0 0
0 0 0 52 0 0 52 0 0 0 0
3 0 0 102 0 0 0 0 102 0 0
0 0 0 0 0 0 0 0 0 0 0
0 31 0 0 0 0 101 0 0 0 0
0 0 21 0 0 0 101 0 0 101 101
0 0 0 31 0 0 101 0 101 0 0
0 0 0 0 21 0 0 0 0 101 0
0 0 0 0 0 31 101 0 0 0 0
0 0 0 0 0 0 101 0 0 0 0
0 0 0 0 0 0 101 101 0 0 101
0 0 0 0 65 0 101 21 0 0 0
0 0 0 0 0 0 101 0 31 0 0
0 0 0 52 0 0 101 101 101 0 0
0 0 0 35 0 0 101 0 0 21 0
0 0 0 0 0 0 101 0 0 0 31
0 0 0 0 0 0 101 0 0 101 101
0 0 0 32 0 0 101 0 0 0 0
0 0 32 0 0 0 101 0 101 0 0
1 32 0 0 0 0 0 0 102 0 0
0 0 102 0 0 0 0 0 0 0 0
0 0 0 0 0 0 0 0 0 0 0
0 0 0 0 0 0 0 0 0 0 32
0 0 0 121 0 0 0 0 0 32 0
0 0 0 0 0 0 0 0 32 0 0
0 0 0 0 0 0 0 32 0 0 0
0 0 121 0 0 0 32 0 0 0 0
0 0 0 0 0 32 0 0 0 0 0
0 0 0 0 32 0 0 0 0 0 0
0 0 0 32 0 0 0 0 0 122 0
0 0 32 0 0 0 0 0 0 122 0
0 32 0 0 0 0 0 0 0 0 0
0 0 0 0 0 0 65 0 0 0 0
0 32 0 0 0 0 0 0 121 0 0
0 0 32 0 0 0 0 53 0 0 0
0 0 0 32 0 0 0 0 0 0 0
3 0 0 0 32 0 0 0 0 0 0
0 0 36 0 0 32 0 0 0 121 0
0 0 0 0 0 0 32 0 0 0 0
28 0 0 0 0 0 0 32 0 0 0
27 0 0 122 0 0 0 0 32 0 0
29 0 122 0 0 0 0 0 0 32 0
26 0 0 0 0 0 0 0 0 0 32
24 0 21 22 0 0 0 0 0 0 0
22 0 21 22 0 0 0 0 0 0 0
22 0 0 21 0 0 0 0 0 0 0
23 0 27 0 0 0 0 0 0 102 0
25 0 0 0 0 0 0 0 0 0 0
28 0 0 37 0 0 0 0 0 0 0
27 0 0 38 0 0 0 0 0 0 0
29 0 0 0 0 0 0 52 0 0 0
5 0 0 53 0 21 0 0 0 0 0
0 0 0 0 0 0 0 0 0 0 0
0 0 0 21 0 0 0 0 0 21 0
0 0 0 0 122 0 0 0 0 0 0
0 0 0 0 0 21 0 0 0 0 0
0 0 0 0 0 0 0 0 0 0 0
0 0 0 21 0 50 56 0 0 0 0
0 0 121 0 0 0 0 0 0 0 0
0 0 0 0 0 0 0 0 0 0 0
0 0 0 0 0 0 0 0 0 0 0
0 0 0 22 0 0 0 0 0 0 0
0 55 55 55 55 55 0 0 0 0 0
0 0 0 0 0 0 0 0 0 0 0
0 55 55 55 55 55 0 0 0 0 0
0 0 0 0 0 0 0 0 0 21 0
0 55 55 55 55 55 0 0 0 0 0
0 0 0 0 21 0 0 0 0 0 0
0 55 55 55 55 55 0 0 0 0 0
0 0 0 0 0 0 0 0 0 0 0
0 55 55 55 55 55 0 0 0 0 0
0 0 0 0 0 0 0 0 0 21 0
0 55 55 55 55 55 0 0 0 0 0
0 0 0 0 0 0 0 0 0 0 0
0 55 55 55 55 55 0 0 0 0 0
0 0 0 0 21 0 0 0 0 0 0
0 55 55 55 55 55 0 0 0 0 0
0 0 38 0 0 0 0 0 0 0 0
0 55 55 55 55 55 0 0 0 0 0
0 0 0 0 0 0 0 0 0 0 0
0 55 55 55 55 55 0 0 0 0
0 0 0 0 102 0 0 102 0 0 0
0 999 0 0 0 0 0 0 0 0 0
0 0 0 0 0 0 0 0 0 0 0
0 0 0 0 0 0 0 0 0 0 0
0 998 0 0 0 0 0 0 0 0 0
0 0 0 0 0 0 0 0 0 0 0
0 0 0 0 0 0 0 0 0 0 0
0 0 0 0 0 1001 0 0 0 0 0
0 0 0 0 0 0 0 0 0 0 0