1
160
0 0 0 0 0 16 0 0 0 0 0
0 0 0 0 0 0 0 0 0 0 0
0 0 121 0 0 0 0 0 0 0 0
0 0 0 0 0 0 0 0 0 0 0
33 0 121 0 0 0 0 0 0 0 0
34 0 0 0 0 0 0 0 0 0 0
34 0 0 0 0 0 0 11 0 11 0
35 0 0 0 0 0 0 0 0 121 0
36 0 0 0 0 0 0 0 0 0 0
37 0 0 0 0 0 11 0 0 121 0
37 0 34 0 0 0 0 0 0 0 0
38 0 0 0 0 11 11 11 0 0 0
0 0 0 0 0 0 0 0 0 0 0
0 0 0 0 0 0 0 0 0 0 0
0 0 0 0 0 0 0 0 121 121 0
0 0 0 0 0 0 0 0 0 0 0
39 0 0 11 0 0 0 0 0 0 0
40 0 101 0 0 0 0 54 54 0 0
42 0 0 12 0 0 21 0 0 0 0
40 0 101 0 0 21 0 0 0 0 0
41 0 0 11 0 0 0 0 0 0 0
0 0 0 0 0 0 0 0 0 0 0
0 0 0 0 0 102 0 0 0 0 0
0 0 0 67 0 0 0 0 0 0 0
0 0 0 0 0 0 25 0 0 0 0
0 0 0 0 66 0 0 25 0 0 0
0 0 0 0 0 0 25 0 0 0 0
5 0 0 25 0 0 0 25 0 0 0
9 0 0 26 0 0 25 0 0 0 0
9 0 0 25 0 0 0 0 0 0 0
21 0 0 0 0 0 0 0 0 0 0
21 0 12 0 0 0 0 0 25 12 0
13 0 0 0 0 21 0 0 0 0 0
21 0 12 0 0 21 0 0 25 12 0
11 0 50 0 0 0 0 0 0 56 0
30 0 0 0 0 0 0 0 0 0 0
30 0 0 0 0 0 121 0 0 0 0
30 0 0 0 0 0 21 0 0 0 0
30 0 0 0 0 0 0 0 0 0 0
31 0 41 0 0 0 0 0 0 0 0
0 0 0 0 0 102 0 0 0 0 0
0 0 0 0 0 0 0 0 0 121 0
0 0 0 21 0 0 0 0 21 0 0
0 0 0 0 0 0 0 0 0 0 0
51 0 42 21 0 0 0 0 0 0 0
49 0 0 0 0 0 0 0 0 0 0
55 0 0 0 0 0 0 0 0 0 0
49 0 12 0 0 0 0 0 24 25 0
49 0 12 0 0 0 0 0 0 0 0
55 0 0 0 0 0 0 0 0 0 0
49 31 0 0 0 0 121 0 0 0 0
53 0 31 0 0 0 0 0 0 0 0
0 0 0 31 0 0 0 0 21 0 0
0 0 0 0 31 0 0 0 0 0 0
0 0 0 0 0 31 0 0 0 0 0
21 0 0 11 0 0 31 0 11 0 0
22 11 0 0 0 0 31 0 0 0 11
21 0 0 11 0 0 0 31 11 0 0
0 0 0 0 0 0 0 0 31 0 0
0 22 65 22 0 0 0 0 0 0 31
0 0 0 0 0 0 0 0 0 0 31
0 0 0 0 0 121 0 0 0 31 0
0 0 0 0 0 0 0 0 31 0 0
0 0 0 21 0 0 0 31 0 0 0
52 0 0 0 0 0 31 0 0 101 0
50 0 22 0 0 31 0 0 0 0 0
56 0 0 0 31 0 0 0 0 0 0
50 0 0 31 0 0 0 0 0 11 0
50 0 31 0 0 0 0 121 121 0 0
56 31 0 0 0 0 0 0 0 0 0
50 0 35 102 0 0 0 102 0 0 0
54 0 34 0 0 0 0 0 0 0 0
0 0 0 0 0 21 121 0 0 0 0
0 0 0 0 0 0 0 21 0 0 0
0 0 0 0 0 0 0 0 121 0 0
0 0 0 0 0 0 0 0 0 0 0
0 0 0 0 0 0 21 21 0 0 0
0 0 0 0 0 0 0 22 0 22 0
18 0 21 0 0 0 0 0 0 21 0
19 0 0 12 0 0 0 0 12 0 0
19 0 0 0 0 0 0 0 0 0 0
14 0 0 0 0 0 0 0 0 0 0
19 0 33 0 11 0 0 11 0 0 0
19 0 0 0 11 0 0 11 0 0 0
19 0 0 0 0 0 0 0 0 0 0
16 0 35 0 12 0 0 12 0 0 0
5 0 0 0 0 0 0 0 0 0 0
32 0 0 0 11 0 0 11 0 0 0
32 0 34 0 0 0 0 0 0 0 0
32 0 0 23 0 0 0 0 23 0 0
32 0 0 0 0 0 0 0 0 0 0
32 0 0 0 11 0 0 11 0 0 0
17 0 21 0 0 0 0 0 0 0 0
20 21 36 0 0 0 0 0 0 0 0
20 102 0 0 0 0 0 0 0 0 102
19 0 0 0 0 0 0 23 0 0 0
19 22 0 0 0 0 0 0 0 22 0
20 0 0 0 0 0 0 21 0 21 0
20 0 0 0 0 0 0 0 0 0 0
16 0 0 12 0 0 0 0 12 0 0
0 0 0 0 0 0 0 0 0 0 0
0 0 50 0 0 0 0 0 0 0 0
0 0 0 0 0 0 21 0 0 0 0
2 0 50 0 0 0 0 0 22 0 0
0 0 0 0 0 0 21 0 0 0 0
2 0 0 0 0 0 0 0 0 121 0
4 0 0 0 0 0 0 0 0 21 0
0 0 0 0 0 0 23 0 0 0 0
0 0 0 0 0 0 0 0 0 0 0
0 0 0 0 0 56 0 0 0 0 0
51 0 21 0 0 0 0 0 0 0 0
53 0 0 0 22 0 0 0 0 56 0
52 0 0 0 0 0 0 0 0 0 0
54 0 37 0 0 0 0 0 0 0 0
51 0 0 0 0 0 0 0 0 21 0
53 0 0 0 0 0 0 0 0 0 0
52 0 24 0 0 0 0 0 0 24 0
54 0 0 0 0 0 0 25 0 0 0
0 0 26 0 0 0 0 0 0 0 0
0 0 0 0 0 0 0 25 0 0 0
1 0 0 32 0 0 0 0 32 0 0
0 0 0 0 0 0 0 0 0 0 0
0 0 0 0 21 0 0 0 0 0 0
22 0 0 0 0 0 0 25 26 25 0
21 0 0 0 0 0 0 0 0 0 0
21 41 0 0 0 0 0 0 0 0 0
21 0 0 0 21 0 0 0 0 0 0
21 0 22 21 0 0 0 0 0 0 0
22 0 21 0 0 0 0 0 0 0 0
21 0 0 0 0 0 0 0 0 0 0
21 0 0 0 0 0 21 0 0 0 0
21 0 0 0 0 0 0 0 0 0 0
21 40 39 0 0 0 0 0 0 0 0
22 0 0 0 0 0 0 21 0 0 0
23 39 40 0 0 0 0 0 0 0 0
25 0 0 0 0 0 0 0 0 0 0
27 0 0 0 0 0 24 0 0 24 0
27 0 0 0 0 0 0 0 52 0 0
26 0 0 0 0 0 0 0 0 0 0
24 0 0 0 0 0 0 0 0 53 0
22 0 0 0 0 53 52 0 0 0 0
0 31 0 0 0 0 0 0 0 121 0
0 0 0 31 0 0 0 0 0 0 0
0 0 0 0 0 31 0 21 0 0 0
0 0 0 121 0 0 0 31 0 0 0
0 0 0 0 0 0 0 0 0 31 0
0 21 0 0 102 0 0 102 0 0 0
0 0 0 0 0 0 0 0 0 0 32
0 0 0 121 0 0 0 0 32 0 0
0 0 0 0 0 0 32 0 0 0 0
0 0 0 0 32 0 0 0 21 0 0
0 0 32 0 0 0 0 0 0 0 0
0 0 0 0 0 0 0 0 0 0 121
0 999 0 0 0 0 0 0 0 0 0
0 0 0 0 0 0 0 0 0 0 0
0 0 0 0 0 0 0 0 0 0 0
0 998 0 0 0 0 0 0 0 0 0
0 0 0 0 0 0 0 0 0 0 0
0 0 0 0 0 0 0 0 0 0 0
0 0 0 0 0 1000 0 0 0 0 0
